NO  ./map/North texture.xpm


SO  ./map/South_texture.xpm

WE   ./map/West_texture.xpm

EA  ./map/East_texture.xpm

F       255,255,255

C          20,  ,25

11111111111111111111111111111111
10000000000001111111111
10000000000000000000001
10000000000E00000000001
10000000000000000000001
11111111111111111111111