NO  ./map/North_texture.xpm


SO  ./map/South_texture.xpm

WE   ./map/West_texture.xpm

EA  ./map/East_texture.xpm

F       255,255,255

C          20,200,255

11111111111111111111111111111111111111111111111111111
11000000000000000000000000000000000000000000000000001
10000000000000000000000000000000000000000000000000011
11000000000000000000000000000000000000000000000000001
10000000000000000000000000000000000000000000000000011
11000000000000000000000000000000000000000000000000001
10000000000000000000000000000000000000000000000000011
11000000000000000000000000000000000000000000000000001
10000000000000000000000000000000000000000000000000011
11000000000000000000000000000000000000000000000000001
11000000000000000000000000000000000000000000000000001
10000000000000000000000000000000000000000000000000011
11000000000000000000000000000000000000000000000000001
10000000000000000000000000000000000000000000000000011
11000000000000000000000000000000000000000000000000001
10000000000000000000000000000000000000000000000000011
11000000000000000000000000000000000000000000000000001
10000000000000000000000000000000000000000000000000011
11000000000000000000000000000000000000000000000000001
10000000000000000000000000000000000000000000000000011
11000000000000000000000000000000000000000000000000001
1000000000000000000000000E000000000000000000000000011
11000000000000000000000000000000000000000000000000001
10000000000000000000000000000000000000000000000000011
11000000000000000000000000000000000000000000000000001
10000000000000000000000000000000000000000000000000011
11000000000000000000000000000000000000000000000000001
10000000000000000000000000000000000000000000000000011
11000000000000000000000000000000000000000000000000001
10000000000000000000000000000000000000000000000000011
11000000000000000000000000000000000000000000000000001
10000000000000000000000000000000000000000000000000011
11000000000000000000000000000000000000000000000000001
10000000000000000000000000000000000000000000000000011
11000000000000000000000000000000000000000000000000001
10000000000000000000000000000000000000000000000000011
11111111111111111111111111111111111111111111111111111
