NO  ./map/North_texture.xpm

SO  ./map/South_texture.xpm

WE   ./map/West_texture.xpm

EA  ./map/East_texture.xpm

F       255,255,255

C          20,200,255

        111111111 11111111111111
        100000001 10000000000111111
        110000111 10111011110110001111
        10010000111000011  10001110111
1111111100110000000000001  10000001111
1000100000110001111111111  11111111
1111011111111101             10001
11100111111110111 1111111111111111111
11100000110E01011 10000001
  100000000000001 100000011111
111000000000000111101010011111
1111111111000111111110111111
    101 1110101 10111101
    111 1111111 11111111
